0000000000000000000000000000000000000000000000000000000000000000000000
0000000000000000000000000000000000000000000000000000000000000000000000
0000000000000000000000000000000000000000000000000000000000000000000000
0000000000000000000000000000000000000000000000000000000000000000000000
0000000000000000000000000000000000000000000000000000000000000000000000
0000000000000000000000000000000000000000000000000000000000000000000000
0000000000000000000000000000000000000000000000000000000000000000000000
1000000000000000000000000000000000000000000000000000000000000000000001
3000000000000000000000000000000000000000000000000000000000000000000004
3000000000000002111600000000000000000000000000000000000000000000000004
3000000000000000000000000000000000000000000000000000000000000000000004
3000000000000000000000000000000000000000000000000000000000000000000004
3000000000000000000000000000000000000000000000000000000000000000000004
3111111111111111111111111111111111111111111111111111111111111111111114
3555555555555555555555555555555555555555555555555555555555555555555554
3555555555555555555555555555555555555555555555555555555555555555555554
3555555555555555555555555555555555555555555555555555555555555555555554
3555555555555555555555555555555555555555555555555555555555555555555554
3555555555555555555555555555555555555555555555555555555555555555555554
3555555555555555555555555555555555555555555555555555555555555555555554
8777777777777777777777777777777777777777777777777777777777777777777779