0000000000000000000000000000000000000000000000000000000000000000000000
0000000000000000000000000000000000000000000000000000000000000000000000
0000000000000000000000000000000000000000000000000000000000000000000000
0000000000000000000000000000000000000000000000000000000000000000000000
0000000000000000000000000000000000000000000000000000000000000000000000
0000000000000000000000000000000000000000000000000000000000000000000000
0000000000000000000000000000000000000000000000000000000000000000000000
0000000000000000000000000000000000000000000000000000000000000000000000
0000000000000000000000000000000000000000000000000000000000000000000000
0000000000000002111600000000000000000000000000000000000000000000000000
0000000000000000000000000000000000000000000000000000000000000000000000
0000000000000000000000000000000000000000000000000000000000000000000000
0000000000000000000000000000000000000000000000000000000000000000000000
2111111111111111111111111111111111111111111111111111111111111111111116
3555555555555555555555555555555555555555555555555555555555555555555554
3555555555555555555555555555555555555555555555555555555555555555555554
3555555555555555555555555555555555555555555555555555555555555555555554
3555555555555555555555555555555555555555555555555555555555555555555554
3555555555555555555555555555555555555555555555555555555555555555555554
3555555555555555555555555555555555555555555555555555555555555555555554
8777777777777777777777777777777777777777777777777777777777777777777779